18  12
WWWWWWWWWWWWWWWWWW
P.WD..M.....WD...W
W.WWW.W.WWW.W.WW.W
W.H.W.W.W.M.W.WW.W
W.WWW.W.WDW.W.WW.W
W.....W.W.W.W.WWDW
W.WWWWW.....W.WW.W
W.W.D...WWW.W.WW.E
W.W.WWW.WW.......W
W.W.WWWWWW.WWWWW.W
W.D...H..W....DWDW
WWWWWWWWWWWWWWWWWW
