10 10
.WWWEWWWW.
WDW.M.M.PW
W...M..WHW
W...H....W
W.WDWD...W
W.WHWWWHMW
W...MDW..W
W.M...W..W
W.H......W
.WWWWWWWW.
