15  15
WWWWWWWPWWWWWWW
W.....W.W.....W
W.WWW.W.W.WWW.W
W.WDW.W.W.WDW.W
W.W...W.W...W.W
W.WWWWW.WWWWW.W
W.............E
W.WWWWW.WWWWW.W
W.W...W.W...W.W
W.WDW.W.W.W.W.W
W.WWW.W.W.W.W.W
W.....W.W.WDW.W
W.WWWWW.W.WWW.W
W.......W.....W
WWWWWWWWWWWWWWW
