12 12
.WWWWWWWWWW.
WD...MDWWD.W
WWMW.M..W.PW
WD.M..M.WWMW
W..D.W..M..W
WHMW.W..WD.W
W..HDW...HWW
W..M.MD..H.W
W..W.MDW.HWW
W.MW.W.W..WW
WD.MD...M.DE
.WWWWWWWWWW.
