20 20
.WWWWWWWWWWWWWWWWWW.
WD..D..M.WWD.W....DW
W.W...H.DWWW.W.WDW.W
W.DM..WW.WW.H..HM..W
W.WHH.W.M..M.W.H..DW
W.....W.M..M.W.....W
WWW.WWD..WW..DWWWH.W
W..H...H.WWHH...W.MW
WDW.MM.H..W...MM.D.W
WWWW..WWWHH.WW..WWWW
WWWW..WW..HWWW..WWWW
W.D.MM...W..H.MM.WDW
WM.W...HHWW.H...H..W
W.HWWWD..WW..DWW.WWW
W.....W.M..M.W.....W
WD..H.W.M..M.W.HHW.W
W..MH..H.WW.WW..MD.W
W.WDW.W.WWWD.H...W.W
WD....W.DWW.M..D..PW
.EWWWWWWWWWWWWWWWWW.
