10 10
.WWWWWWWW.
W.H.....PW
WWWDHHWMWW
W.W...M..W
W.W..WD..W
W.E..WWWWW
W.M....DWW
W.H.HWHM.W
W........W
.WWWWWWWW.
