13 13
.WWWWWWWWWWW.
W.....W....EW
W....HDH....W
W...HDHDH...W
W..HDHDHDH..W
W.HDHDHDHDHPW
WWDHDHDHDHDHW
W.HDHDHDHDH.W
W..HDHDHDH..W
W...HDHDH...W
W....HDH....W
W.....W.....W
.WWWWWWWWWWW.
