13 13
.WWWWWWWWWWW.
W.....M....PW
W..H.H.H.H..W
W.H...M...H.W
W....H.H....W
W.H.H.M.H.H.W
WM.M.MEM.M.MW
W.H.H.M.H.H.W
W....H.H....W
W.H...M...H.W
W..H.H.H.H..W
W.....M.....W
.WWWWWWWWWWW.
