10 8
.WWWWWWWW.
WDW.W..MPW
W.MDM...MW
W.....M..W
WHW..MEWHW
W...M.D..W
W..M...H.W
.WWWWWWWW.
