13 13
.WWWWWWWWWWW.
W...H..H..HPW
W.H.W..W..W.W
W.W.W..H..H.W
W.H.W..W..W.W
W.W.W..H..H.W
W.H.W..W..W.W
W.W.W..H..H.W
W.H.W..W..W.W
W.W.W..H..H.W
W.H.W..W..W.W
W...W..W..H.W
.EWWWWWWWWWW.
