13 13
.WWWWWWWWWWW.
WD.D.D.D.D.DW
W.H.H.H.H.HPW
WD.D.D.D.D.DW
W.H.H.H.H.H.W
WD.D.D.D.D.DW
W.H.H.E.H.H.W
WD.D.D.D.D.DW
W.H.H.H.H.H.W
WD.D.D.D.D.DW
W.H.H.H.H.H.W
WD.D.D.D.D.DW
.WWWWWWWWWWW.
