8 10
.WWWWWW.
WD..W..W
W.W.H.DW
W..WWW.W
W..MPH.W
W..WWW.W
W.....DW
W.M.H..W
WW.DED.W
.WWWWWW.
