13 13
.WWWWWWWWWWW.
WW....W...MPW
W.HM..W..MHMW
W..H..W..H..W
W..MH.W.HM..W
W.....M.....W
WWWWWMEMWWWWW
W.....M.....W
W..MH.W.HM..W
W..H..W..H..W
W.HM..W..MH.W
WW....W....WW
.WWWWWWWWWWW.
