10 10
.WWWWWWWW.
W.......EW
W.H.H.H..W
W..H.H.H.W
W.H.H.H..W
W..H.H.H.W
W.H.H.H..W
W..H.H.H.W
WP.......W
.WWWWWWWW.
