20 20
.WWWWWWWWWWWWWWWWWW.
WD.WD....WD.W.DW..PW
W..W.....W.M.M.W...W
W..WWW...WW...WWHMMW
W.MW.....W..D..W...W
WM.W.DH.MDMMHWHW...W
W..WWWW.DM...WDW.M.W
W..H.DM.MD...W.MDM.W
W..M.H...M...W...M.W
WH.M.....H.........W
W..D.....HMWW.HHWWWW
W......D.H.........W
WWWWWWWWWWWWWW..MMWW
WD..WDM....W....DH.W
W..W...M...W....WWWW
W.W...M.M...W..M.WDW
W.H..M...M....M..H.W
W.M..W...W...M...M.W
WD......DW..M......W
.WWWWWWWWWWWWWWWWEW.
