20 20
WWWWWWWWWWWWWWWWWWWW
W..................W
W...DDDD......DDDD.W
W..D.........D.....W
W.D.........D......W
W.D.........D......W
W.D..........DD....W
W.D......E.....DD..W
W.D..............D.W
W.D..............D.W
W..D............D..W
W...DDDD....DDDD...W
W..................W
WMMMMMMMMMMMMMMMMMMW
W..................W
W.H..H..H..H.H..H..W
W.H..H..H..H.H..H..W
W.H..H..H..H.H..H..W
W........P.........W
WWWWWWWWWWWWWWWWWWWW


