13 13
.EWWWWWWWWWW.
W....W..M.WPW
W.WWWWW.W.W.W
W..W..M.W.WMW
W.WW..WW.M..W
W..M.M...W..W
W..M...W.WWWW
WWWWWWWWM...W
W.W..M...WW.W
W..W.W..W.M.W
W.HW.W.WWW.WW
WW...W......W
.WWWWWWWWWWW.
