13 13
.WWWWWWWWWWW.
W.H......DW.W
WEDMDWWMWWDHW
WDW.....W.M.W
W.WWWHW.W.D.W
W.M.....H.W.W
W.W.W.P.W.W.W
W.W.H.....M.W
W.D.W.WHWWW.W
W.M.W.....WDW
WHDWWMWWDMDWW
W.WD......H.W
.WWWWWWWWWWW.
