15 15
.WWWWWWWWWWWWW.
WD....DWD...WDW
W.W....M....W.W
W.W...DMD....PW
WWWMWWWMWWWWWMW
WDD.WWD.DWW..DW
WDD.WD...DW..DW
WWMMM..D..MMMWW
WD..WDE..DW.DDW
WD..WWD.DWW.DDW
WWWMWWWMWWWMWWW
W.....DMD...W.W
W.W....M....W.W
WDW...DWD....DW
.WWWWWWWWWWWWW.
