9 11
WWWWEWWWW
WPW...W.W
W.W.W.W.W
W.H.H.H.W
W.W.W.W.W
W.W.W.W.W
W.H.H.H.W
W.W.W.W.W
W.W.W.W.W
W...W...W
WWWWWWWWW
