12 12
.WWWWWWWWWW.
WD..DWWD..DW
W.H..WW..H.W
WWW..WW..WWW
W.DMWWWWMD.W
WPM..DD..MHW
WHM..DD..M.W
W.DMWWWWMD.W
WWW..WW..WWW
W.H..WW..H.W
WD..DWWD..DE
.WWWWWWWWWW.
