10 10
.EWWWWWWW.
WDDDDDDDPW
WDDDDDDDDW
WD.DDDDDDW
WDMDMDMDMW
WMDMDMDMDW
WDDDDDD.DW
WDDDDDDDDW
WDDDDDDDDW
.WWWWWWWW.
