13 13
.WWWWWWWWWWW.
WW....M....WW
WPW..WDW..M.W
W..W..M..W..W
W...WW.WW...W
W.WHWD.DWHW.W
WMDM..E..MDMW
W.WHWD.DWHW.W
W...WW.WW...W
W..W.HMH.W..W
W.M..WDW..M.W
WW....M....WW
.WWWWWWWWWWW.
