13 13
.WWWWWWWWWWW.
WWDWWW.WWWDWW
WDD.......DDW
WW.WWW.WWW.WW
WW.WD...DW.WW
WW.W.WMW.W.WW
WWMWHWPWHWHWW
WW.W.WWW.W.WW
WW.W.....W.WW
WW.WWWWWWW.WW
W...........W
WW.WWWEWWW.WW
.WWWWWWWWWWW.
